...T.....B
.T......T.
.R....T...
.M.B.T....
.BTM......
...T......
....Y.....
.T....R...
.....R....
BR....MB..
