..Y....B..
..........
...BM.....
...T..R...
.M...T....
.........T
M..T..M...
......RB..
...M......
...T..M..B