..Y....B..
..........
....M.....
...T..R...
.M...T....
.........T
...TB.M...
......R...
..........
...T..M...