..........
..MB.T....
...T......
.T........
..R....T..
.B..T.....
...Y......
.T...R....
.....R....
.BT....R.B