....B.....
.MT.......
....R.....
.T........
.T..T.B...
.R...T....
....B..M..
.T......B.
.....R....
.Y...BR...