..MB......
..T.R..T..
.....BT...
.T....R...
....MBT...
..T.......
..B...T...
.R...T....
.....R....
....Y.M.B.
