.Y........
...M...B..
..TB......
...M..R...
...T...T..
..........
.B........
......M...
...T......
R.....M..B