...B.....
.T..T.M..
.....B...
.M.T..M..
....R....
B...R....
.T.T..M..
.....B...
....Y....
......R..
