.T....B..
....T.M..
.....B...
.Y.T..M..
....R....
....R....
...T..M..
.....B...
.........
......R..
