.......M.B
.M....M...
.....R....
..........
.T......T.
.B...TB...
..R.......
..........
.Y..T..M..
....M.....
